NO ./textures/
SO ./textures/
WE ./textures/
EA ./textures/

F 65,100,0
C 0,30,120

111111
100101
101001
1100N1
111111
